3000000000000000000000000000000000000000000000000000000000000000000000000000000000000000000000000000000000000003
3000000000000000000000000000000000000000000000000000000000000000000000000000000000000000000000000000000000000003
3000000000000c00000000000000000000000000000000000000000000000000000000000c00000000000000000000000000000000000003
3000000000000000000000000000000000000000222220000000000s00000000000000000000000000000000000000000000000000000003
300000000002222200000000000000000000000000000000002222220000000000000000d0d0dr0000000000000000000000000000000003
3000000000000000000000000000000022222000000000000000000000000000000000222222220000000000000000000000000000000003
30000000000u0000000000000000000000000000000000000000000000000000000000000000000000000000000000000000000000000003
300000000000000000000000000000j00000000000003c00r0ru0000000000000000000u0u0u0000jr0000000ssss00rrrrrrrr0000e0003
3020000000000000000000002222222000000000000002222222000000000000222222222222222222000002222222222222222222222223
3000000j0000000000j000021111111000000000000001111111000000000000111111111111111111000021111111111111111111111113
300j000000000000000000011111111000000000000001111111000000000000111111111111111111000011111111111111111111111113
3000000000000000000000011111111000000000000001111111000000000000111111111111111111000011111111111111111111111113
3000000000000000000000011111111000000000000001111111000000000000111111111111111111000011111111111111111111111113
3000000000000000000000011111111000000000000001111111000000000000111111111111111111000011111111111111111111111113
